******************************
*                            *
*                            *
*                            *
*                            *
*                            *
*                            *
*                            *
*                            *
*                            *
*                            *
*                            *
*                            *
*                            *
*                            *
*                            *
*                            *
*                            *
*                            *
******************************